name,tenured_total,white_tenured,white_men_tenured,white_women_tenured,black_tenured,black_men_tenured,black_women_tenured,his_tenured,his_men_tenured,his_women_tenured,asian_tenured,asian_men_tenured,asian_women_tenured,ind_tenured,ind_men_tenured,ind_women_tenured,unknown_tenured,unknown_men_tenured,unknown_women_tenured,student_total,white_student,white_men_student,white_women_student,black_student,black_men_student,black_women_student,his_student,his_men_student,his_women_student,asian_student,asian_men_student,asian_women_student,ind_student,ind_men_student,ind_women_student,unknown_student,unknown_men_student,unknown_women_student
Abilene Christian University,103,99,83,16,2,1,1,1,0,1,0,0,0,1,1,0,0,0,0,4234,3456,1568,1888,244,124,120,258,95,163,31,7,24,18,8,10,44,17,27
Alvin Community College,60,57,34,23,1,1,0,2,0,2,0,0,0,0,0,0,0,0,0,3671,2590,1108,1482,294,202,92,662,307,355,59,25,34,14,9,5,43,23,20
Amarillo College,83,79,41,38,2,0,2,0,0,0,1,1,0,1,0,1,0,0,0,8757,6328,2590,3738,301,101,200,1672,640,1032,225,101,124,79,34,45,150,53,97
Angelo State University,96,82,60,22,2,2,0,6,3,3,2,1,1,3,2,1,0,0,0,657,358,118,240,228,74,154,33,11,22,7,4,3,8,3,5,23,8,15
Austin College,62,61,47,14,1,0,1,0,0,0,0,0,0,0,0,0,0,0,0,4671,3448,1314,2134,728,191,537,413,180,233,43,20,23,38,9,29,1,0,1
Austin Presbyterian Theological Seminary,7,5,3,2,1,1,0,1,1,0,0,0,0,0,0,0,0,0,0,5833,4222,1881,2341,305,149,156,1161,486,675,68,38,30,19,10,9,0,0,0
Baylor College of Medicine,306,265,213,52,2,2,0,11,8,3,26,17,9,0,0,0,0,0,0,240,208,125,83,3,2,1,14,11,3,2,2,0,0,0,0,0,0,0
Baylor University,385,365,269,96,3,2,1,10,8,2,4,3,1,1,1,0,1,1,0,237,126,1,125,54,1,53,50,1,49,1,0,1,1,0,1,5,0,5
Brazosport College,38,36,26,10,1,0,1,0,0,0,1,1,0,0,0,0,0,0,0,1551,461,264,197,107,55,52,229,136,93,58,33,25,5,2,3,690,406,284
Cisco College,34,30,21,9,2,0,2,1,0,1,0,0,0,1,1,0,0,0,0,1227,941,411,530,57,29,28,85,39,46,105,42,63,9,3,6,0,0,0
Clarendon College,2,2,2,0,0,0,0,0,0,0,0,0,0,0,0,0,0,0,0,29322,18204,8364,9840,1950,717,1233,6191,2741,3450,1818,847,971,270,165,105,414,186,228
Concordia University Texas,3,3,3,0,0,0,0,0,0,0,0,0,0,0,0,0,0,0,0,81,55,1,54,5,0,5,21,2,19,0,0,0,0,0,0,0,0,0
Texas A & M University-Corpus Christi,131,107,61,46,2,2,0,18,14,4,3,2,1,0,0,0,0,0,0,282,123,17,106,21,3,18,115,26,89,3,0,3,0,0,0,20,5,15
Dallas Baptist University,2,2,1,1,0,0,0,0,0,0,0,0,0,0,0,0,0,0,0,34,20,20,0,10,9,1,0,0,0,1,1,0,3,2,1,0,0,0
Dallas Theological Seminary,29,28,27,1,0,0,0,0,0,0,1,1,0,0,0,0,0,0,0,12190,9377,3947,5430,682,231,451,907,388,519,616,291,325,61,27,34,317,148,169
University of Dallas,62,59,49,10,0,0,0,1,0,1,1,1,0,1,0,1,0,0,0,3259,1119,503,616,185,148,37,1899,725,1174,19,9,10,14,10,4,18,10,8
Del Mar College,185,132,70,62,6,1,5,40,18,22,6,4,2,1,1,0,0,0,0,12484,9850,4820,5030,964,447,517,1249,580,669,142,76,66,56,33,23,4,2,2
East Texas Baptist University,9,8,5,3,0,0,0,1,1,0,0,0,0,0,0,0,0,0,0,582,192,69,123,243,50,193,130,34,96,17,9,8,0,0,0,0,0,0
Texas A&M University-Texarkana,20,20,14,6,0,0,0,0,0,0,0,0,0,0,0,0,0,0,0,158,23,3,20,20,2,18,115,5,110,0,0,0,0,0,0,0,0,0
Texas A & M University-Commerce,106,96,71,25,6,3,3,2,1,1,2,1,1,0,0,0,0,0,0,4022,2678,1305,1373,308,133,175,937,502,435,50,18,32,26,16,10,12,7,5
El Paso Community College,224,116,61,55,7,0,7,98,54,44,3,2,1,0,0,0,0,0,0,9135,4663,1849,2814,1097,365,732,1747,702,1045,1006,463,543,58,26,32,201,97,104
Western Technical College,22,12,5,7,1,0,1,8,4,4,1,1,0,0,0,0,0,0,0,3967,1428,627,801,1998,740,1258,401,189,212,46,20,26,21,9,12,58,25,33
Western Technical College,16,5,5,0,0,0,0,11,11,0,0,0,0,0,0,0,0,0,0,15473,7280,4359,2921,4546,2364,2182,2184,1251,933,639,380,259,145,85,60,591,478,113
Episcopal Theological Seminary of the Southwest,5,5,4,1,0,0,0,0,0,0,0,0,0,0,0,0,0,0,0,49,25,1,24,13,0,13,10,0,10,1,0,1,0,0,0,0,0,0
Galveston College,27,25,16,9,0,0,0,2,0,2,0,0,0,0,0,0,0,0,0,2716,1949,805,1144,294,178,116,387,169,218,33,21,12,19,9,10,0,0,0
Hardin-Simmons University,77,75,60,15,0,0,0,2,2,0,0,0,0,0,0,0,0,0,0,890,658,320,338,102,80,22,109,69,40,7,6,1,4,2,2,0,0,0
Hill College,10,10,7,3,0,0,0,0,0,0,0,0,0,0,0,0,0,0,0,799,577,262,315,43,13,30,99,41,58,11,4,7,3,3,0,66,42,24
University of Houston-Clear Lake,125,105,72,33,1,1,0,6,2,4,13,9,4,0,0,0,0,0,0,52,34,1,33,1,0,1,17,0,17,0,0,0,0,0,0,0,0,0
Houston Community College,50,27,15,12,19,11,8,1,0,1,3,3,0,0,0,0,0,0,0,5178,4339,1800,2539,264,102,162,310,120,190,96,43,53,39,13,26,0,0,0
University of Houston-Downtown,67,50,39,11,5,3,2,3,3,0,9,7,2,0,0,0,0,0,0,5966,3400,1401,1999,145,55,90,2240,889,1351,107,50,57,23,5,18,0,0,0
University of Houston-Victoria,22,15,9,6,1,1,0,1,0,1,5,5,0,0,0,0,0,0,0,80,51,6,45,4,0,4,7,2,5,18,5,13,0,0,0,0,0,0
University of Houston,583,472,373,99,15,9,6,31,23,8,63,52,11,1,1,0,0,0,0,3340,1785,776,1009,681,151,530,251,107,144,45,19,26,96,29,67,292,118,174
Howard Payne University,9,9,6,3,0,0,0,0,0,0,0,0,0,0,0,0,0,0,0,281,207,108,99,44,24,20,20,13,7,1,1,0,3,2,1,1,0,1
Huston-Tillotson University,3,1,0,1,2,1,1,0,0,0,0,0,0,0,0,0,0,0,0,150,88,52,36,44,21,23,17,13,4,0,0,0,0,0,0,0,0,0
University of the Incarnate Word,57,49,20,29,0,0,0,6,4,2,1,1,0,0,0,0,0,0,0,1255,835,365,470,25,11,14,181,71,110,80,25,55,8,1,7,96,34,62
Jacksonville College-Main Campus,11,11,8,3,0,0,0,0,0,0,0,0,0,0,0,0,0,0,0,10256,4271,1773,2498,261,105,156,5435,2207,3228,119,44,75,16,7,9,0,0,0
Jarvis Christian College,6,2,2,0,3,1,2,0,0,0,1,1,0,0,0,0,0,0,0,1509,1214,529,685,188,122,66,55,25,30,1,0,1,9,5,4,3,2,1
Lamar University,196,170,115,55,8,4,4,2,2,0,16,15,1,0,0,0,0,0,0,845,704,212,492,107,23,84,20,3,17,4,1,3,10,3,7,0,0,0
Lamar State College-Orange,19,17,7,10,0,0,0,1,1,0,1,1,0,0,0,0,0,0,0,4498,3421,1400,2021,714,294,420,226,98,128,42,20,22,53,21,32,0,0,0
Lamar State College-Port Arthur,34,32,7,25,2,0,2,0,0,0,0,0,0,0,0,0,0,0,0,9002,4715,2066,2649,1855,550,1305,1733,741,992,475,248,227,48,14,34,113,46,67
Laredo College,118,43,23,20,1,1,0,70,45,25,4,1,3,0,0,0,0,0,0,4597,1384,499,885,1697,427,1270,1137,349,788,142,68,74,30,6,24,51,23,28
Texas A & M International University,48,29,22,7,1,1,0,13,8,5,3,1,2,1,1,0,0,0,0,20063,1981,865,1116,492,204,288,17057,6428,10629,160,69,91,120,52,68,0,0,0
LeTourneau University,26,24,22,2,0,0,0,1,1,0,1,1,0,0,0,0,0,0,0,444,53,21,32,52,39,13,329,207,122,4,3,1,2,2,0,4,3,1
Lubbock Christian University,31,31,19,12,0,0,0,0,0,0,0,0,0,0,0,0,0,0,0,307,31,29,2,5,5,0,267,263,4,0,0,0,2,2,0,2,1,1
College of the Mainland,50,43,26,17,3,2,1,1,1,0,3,1,2,0,0,0,0,0,0,76,64,4,60,0,0,0,12,0,12,0,0,0,0,0,0,0,0,0
University of Mary Hardin-Baylor,33,32,21,11,0,0,0,1,1,0,0,0,0,0,0,0,0,0,0,1424,437,240,197,71,41,30,107,66,41,28,17,11,5,3,2,775,444,331
McLennan Community College,105,91,37,54,8,4,4,5,4,1,1,1,0,0,0,0,0,0,0,193,10,1,9,41,2,39,65,3,62,77,25,52,0,0,0,0,0,0
McMurry University,41,40,27,13,0,0,0,0,0,0,0,0,0,1,1,0,0,0,0,906,720,332,388,45,19,26,115,59,56,2,1,1,13,5,8,0,0,0
Midwestern State University,97,87,65,22,2,1,1,6,4,2,0,0,0,2,0,2,0,0,0,2255,1183,420,763,451,121,330,502,176,326,73,33,40,2,2,0,0,0,0
University of North Texas,455,396,310,86,13,6,7,16,12,4,19,17,2,3,2,1,8,8,0,3471,3091,1208,1883,182,70,112,103,42,61,28,12,16,45,9,36,0,0,0
Odessa College,19,18,15,3,0,0,0,0,0,0,1,1,0,0,0,0,0,0,0,619,197,166,31,53,36,17,351,284,67,15,12,3,2,2,0,1,1,0
Our Lady of the Lake University,32,27,16,11,0,0,0,4,2,2,1,1,0,0,0,0,0,0,0,1902,1628,736,892,72,43,29,134,74,60,12,6,6,7,4,3,45,27,18
The University of Texas Rio Grande Valley,192,131,105,26,3,2,1,41,26,15,12,11,1,1,1,0,1,0,1,4758,3659,1498,2161,722,442,280,324,199,125,16,9,7,15,9,6,3,1,2
Texas Southmost College,128,74,39,35,3,1,2,46,27,19,3,2,1,0,0,0,0,0,0,2694,2183,954,1229,139,56,83,248,104,144,23,14,9,17,6,11,5,5,0
Paris Junior College,19,17,7,10,1,0,1,0,0,0,0,0,0,1,0,1,0,0,0,1953,946,314,632,357,81,276,278,84,194,280,87,193,0,0,0,6,3,3
Paul Quinn College,9,2,2,0,4,3,1,0,0,0,3,3,0,0,0,0,0,0,0,4128,2750,916,1834,321,133,188,633,216,417,273,137,136,16,9,7,0,0,0
Prairie View A & M University,89,11,8,3,61,41,20,2,2,0,14,14,0,0,0,0,0,0,0,38175,10555,4709,5846,8967,2723,6244,9524,3708,5816,4532,2139,2393,93,37,56,736,333,403
Ranger College,12,11,8,3,1,0,1,0,0,0,0,0,0,0,0,0,0,0,0,9643,2384,1094,1290,2638,860,1778,3305,1296,2009,953,500,453,18,7,11,0,0,0
Rice University,325,282,229,53,5,4,1,11,10,1,13,12,1,0,0,0,0,0,0,893,609,162,447,68,17,51,162,46,116,43,14,29,2,1,1,0,0,0
Saint Edward's University,71,66,37,29,2,2,0,2,1,1,0,0,0,1,1,0,0,0,0,25230,9630,4804,4826,3854,1469,2385,5054,2281,2773,5131,2541,2590,113,52,61,422,219,203
St Philip's College,113,65,37,28,20,10,10,24,14,10,2,1,1,2,1,1,0,0,0,2489,1643,670,973,112,56,56,690,257,433,14,6,8,8,6,2,21,12,9
University of St Thomas,74,67,43,24,1,1,0,3,1,2,1,1,0,0,0,0,1,1,0,1521,1048,492,556,114,91,23,158,87,71,28,16,12,3,0,3,170,92,78
Sam Houston State University,232,213,150,63,0,0,0,8,4,4,10,6,4,1,1,0,0,0,0,618,47,21,26,455,179,276,58,37,21,51,37,14,0,0,0,7,6,1
San Antonio College,312,230,140,90,11,4,7,65,38,27,3,2,1,2,2,0,1,1,0,3519,942,319,623,195,62,133,1840,540,1300,55,18,37,19,4,15,215,118,97
Schreiner University,15,14,11,3,0,0,0,0,0,0,1,1,0,0,0,0,0,0,0,546,26,4,22,13,2,11,500,105,395,0,0,0,3,2,1,4,0,4
St. Mary's University,116,96,69,27,4,4,0,16,11,5,0,0,0,0,0,0,0,0,0,228,3,0,3,1,0,1,223,41,182,1,0,1,0,0,0,0,0,0
South Plains College,143,139,76,63,2,0,2,1,0,1,0,0,0,1,1,0,0,0,0,259,162,66,96,73,30,43,7,3,4,2,0,2,0,0,0,0,0,0
South Texas College of Law Houston,32,28,21,7,2,0,2,2,1,1,0,0,0,0,0,0,0,0,0,571,7,4,3,539,221,318,5,2,3,0,0,0,0,0,0,1,0,1
Southern Methodist University,308,275,223,52,5,3,2,7,6,1,21,19,2,0,0,0,0,0,0,151,85,46,39,37,14,23,22,12,10,4,0,4,1,1,0,1,1,0
Southwest Texas Junior College,30,23,13,10,0,0,0,6,4,2,0,0,0,1,0,1,0,0,0,4193,3319,1303,2016,577,191,386,143,57,86,13,7,6,5,4,1,0,0,0
Southwestern Assemblies of God University,16,15,8,7,0,0,0,0,0,0,0,0,0,1,0,1,0,0,0,10271,7099,3409,3690,2276,716,1560,481,229,252,310,149,161,39,18,21,6,1,5
Southwestern University,64,57,37,20,0,0,0,4,2,2,3,2,1,0,0,0,0,0,0,2020,1661,505,1156,266,47,219,46,9,37,15,5,10,6,3,3,24,5,19
Stephen F Austin State University,220,212,154,58,2,1,1,3,1,2,2,2,0,1,1,0,0,0,0,2323,1327,499,828,648,148,500,191,78,113,149,69,80,8,2,6,0,0,0
Texas State University,405,353,243,110,9,5,4,22,14,8,15,11,4,2,2,0,3,3,0,136,2,0,2,0,0,0,133,0,133,0,0,0,0,0,0,0,0,0
Southwestern Adventist University,22,19,13,6,0,0,0,0,0,0,3,2,1,0,0,0,0,0,0,7493,144,63,81,11,6,5,6991,2878,4113,22,9,13,9,4,5,22,15,7
Southwestern Christian College,4,2,2,0,2,1,1,0,0,0,0,0,0,0,0,0,0,0,0,2609,78,30,48,9,4,5,2441,867,1574,6,1,5,2,1,1,0,0,0
Sul Ross State University,57,53,42,11,0,0,0,1,1,0,2,2,0,0,0,0,0,0,0,6336,2697,1359,1338,1365,822,543,2012,1120,892,175,97,78,8,4,4,0,0,0
Tarleton State University,96,87,65,22,1,1,0,3,3,0,4,3,1,1,1,0,0,0,0,2807,2015,1171,844,461,106,355,151,61,90,32,13,19,17,4,13,75,31,44
Tarrant County College District,257,219,111,108,22,10,12,9,4,5,3,3,0,4,0,4,0,0,0,468,179,167,12,104,98,6,165,154,11,9,8,1,0,0,0,11,9,2
Temple College,43,38,19,19,1,0,1,4,2,2,0,0,0,0,0,0,0,0,0,1701,1389,606,783,85,26,59,177,72,105,7,4,3,6,4,2,0,0,0
University of Texas Southwestern Medical Center,237,209,186,23,1,1,0,9,8,1,18,15,3,0,0,0,0,0,0,3346,2049,826,1223,626,195,431,552,204,348,49,25,24,33,10,23,22,11,11
The University of Texas Health Science Center at San Antonio,371,308,235,73,9,7,2,20,16,4,34,26,8,0,0,0,0,0,0,2434,1856,623,1233,263,128,135,236,95,141,41,16,25,15,5,10,0,0,0
The University of Texas Medical Branch at Galveston,271,210,158,52,7,4,3,12,10,2,40,29,11,0,0,0,0,0,0,6133,4220,1551,2669,991,212,779,799,241,558,61,27,34,28,12,16,0,0,0
Texarkana College,88,82,41,41,2,2,0,4,2,2,0,0,0,0,0,0,0,0,0,1378,1020,481,539,114,69,45,182,95,87,20,8,12,18,10,8,11,3,8
Texas A & M University-Kingsville,143,109,88,21,3,3,0,16,9,7,12,12,0,3,2,1,0,0,0,241,179,29,150,11,3,8,48,7,41,3,1,2,0,0,0,0,0,0
Texas A & M University-College Station,1081,930,791,139,17,11,6,45,38,7,74,69,5,1,1,0,0,0,0,5067,3306,1433,1873,238,84,154,1361,579,782,70,39,31,24,13,11,38,15,23
The University of Texas at Arlington,382,313,242,71,5,4,1,7,4,3,52,46,6,2,2,0,0,0,0,5288,3895,1639,2256,431,207,224,462,207,255,148,76,72,61,21,40,0,0,0
The University of Texas at Austin,1309,1132,893,239,37,23,14,49,36,13,72,58,14,8,5,3,0,0,0,70,37,2,35,2,1,1,30,5,25,1,0,1,0,0,0,0,0,0
The University of Texas at Dallas,194,152,125,27,4,4,0,5,4,1,32,31,1,1,1,0,0,0,0,184,88,9,79,68,9,59,22,3,19,3,0,3,1,0,1,1,0,1
The University of Texas at El Paso,257,195,153,42,4,2,2,42,34,8,11,9,2,2,1,1,0,0,0,179,50,5,45,52,4,48,74,8,66,3,0,3,0,0,0,0,0,0
The University of Texas at Tyler,83,80,59,21,0,0,0,1,1,0,0,0,0,0,0,0,0,0,0,6055,1658,736,922,1723,566,1157,2221,895,1326,210,120,90,29,13,16,78,39,39
Texas Chiropractic College Foundation Inc,3,3,2,1,0,0,0,0,0,0,0,0,0,0,0,0,0,0,0,151,12,1,11,20,0,20,22,2,20,97,21,76,0,0,0,0,0,0
Texas Christian University,237,216,156,60,5,1,4,7,5,2,9,7,2,0,0,0,0,0,0,4411,2829,1111,1718,784,358,426,343,127,216,26,12,14,21,8,13,0,0,0
Texas College,1,0,0,0,0,0,0,0,0,0,0,0,0,1,1,0,0,0,0,52,0,0,0,10,1,9,42,4,38,0,0,0,0,0,0,0,0,0
University of North Texas Health Science Center,51,45,42,3,0,0,0,1,1,0,4,3,1,1,1,0,0,0,0,27825,17967,7321,10646,2936,870,2066,4384,1725,2659,1521,716,805,131,48,83,334,126,208
Texas Lutheran University,32,29,19,10,0,0,0,3,3,0,0,0,0,0,0,0,0,0,0,8200,4019,2183,1836,1147,552,595,1352,714,638,868,460,408,47,29,18,175,89,86
The University of Texas of the Permian Basin,38,35,25,10,0,0,0,3,1,2,0,0,0,0,0,0,0,0,0,21675,15299,6824,8475,2243,889,1354,1949,875,1074,968,449,519,167,81,86,416,223,193
The University of Texas at San Antonio,246,180,134,46,3,2,1,33,26,7,25,22,3,5,4,1,0,0,0,2212,1753,669,1084,242,59,183,188,98,90,8,2,6,12,6,6,0,0,0
Texas Southern University,160,24,17,7,113,70,43,5,2,3,18,12,6,0,0,0,0,0,0,24,9,4,5,1,1,0,10,8,2,4,4,0,0,0,0,0,0,0
Texas Tech University,518,465,365,100,4,4,0,13,11,2,33,26,7,1,1,0,0,0,0,111,93,90,3,7,7,0,8,8,0,1,1,0,2,2,0,0,0,0
Texas Wesleyan University,79,72,47,25,1,1,0,4,4,0,2,2,0,0,0,0,0,0,0,4579,2482,1020,1462,189,61,128,1822,706,1116,29,11,18,51,26,25,0,0,0
Texas Woman's University,183,164,56,108,7,0,7,7,3,4,2,1,1,2,0,2,0,0,0,328,205,8,197,54,4,50,46,3,43,22,4,18,1,0,1,0,0,0
Trinity University,154,142,110,32,1,1,0,6,6,0,5,4,1,0,0,0,0,0,0,113,79,3,76,11,0,11,21,0,21,1,1,0,1,0,1,0,0,0
The University of Texas Health Science Center at Houston,246,207,144,63,5,4,1,8,6,2,26,18,8,0,0,0,0,0,0,2196,424,98,326,144,19,125,1469,308,1161,16,5,11,9,4,5,111,25,86
Texas Tech University Health Sciences Center,138,111,87,24,2,2,0,8,7,1,15,14,1,1,1,0,0,0,0,11971,738,326,412,50,30,20,10312,4237,6075,126,42,84,18,11,7,520,204,316
Victoria College,66,63,32,31,0,0,0,3,2,1,0,0,0,0,0,0,0,0,0,8607,375,159,216,24,14,10,8120,3099,5021,19,8,11,4,1,3,13,6,7
Wayland Baptist University,2,2,2,0,0,0,0,0,0,0,0,0,0,0,0,0,0,0,0,1493,1156,412,744,275,69,206,35,12,23,12,6,6,7,1,6,0,0,0
West Texas A & M University,79,74,57,17,0,0,0,1,1,0,4,4,0,0,0,0,0,0,0,3290,2681,1077,1604,443,139,304,85,25,60,22,7,15,50,17,33,1,0,1
Wiley College,2,0,0,0,2,1,1,0,0,0,0,0,0,0,0,0,0,0,0,828,17,4,13,736,354,382,27,12,15,0,0,0,0,0,0,25,25,0
Palo Alto College,70,46,23,23,5,2,3,18,11,7,0,0,0,1,1,0,0,0,0,5387,132,51,81,5040,2201,2839,88,37,51,33,15,18,1,0,1,3,1,2
,,,,,,,,,,,,,,,,,,,,841,569,219,350,135,101,34,113,50,63,3,0,3,4,3,1,11,4,7
,,,,,,,,,,,,,,,,,,,,2728,1453,812,641,190,96,94,293,134,159,389,180,209,15,8,7,312,151,161
,,,,,,,,,,,,,,,,,,,,13313,6057,2744,3313,2088,816,1272,1853,842,1011,1830,956,874,65,31,34,358,193,165
,,,,,,,,,,,,,,,,,,,,3369,1887,832,1055,184,70,114,949,390,559,71,39,32,17,6,11,133,59,74
,,,,,,,,,,,,,,,,,,,,8326,2469,1101,1368,1504,547,957,4147,1961,2186,157,75,82,33,15,18,1,1,0
,,,,,,,,,,,,,,,,,,,,1836,761,271,490,106,26,80,536,183,353,230,84,146,13,4,9,98,36,62
,,,,,,,,,,,,,,,,,,,,11273,8315,3633,4682,1702,668,1034,1035,465,570,104,51,53,56,25,31,0,0,0
,,,,,,,,,,,,,,,,,,,,20064,8707,3801,4906,916,340,576,9674,3902,5772,495,226,269,94,46,48,0,0,0
,,,,,,,,,,,,,,,,,,,,11139,6709,2958,3751,559,238,321,2961,1292,1669,437,208,229,42,14,28,211,108,103
,,,,,,,,,,,,,,,,,,,,791,638,240,398,15,9,6,115,53,62,7,2,5,9,3,6,0,0,0
,,,,,,,,,,,,,,,,,,,,49,26,1,25,2,0,2,21,3,18,0,0,0,0,0,0,0,0,0
,,,,,,,,,,,,,,,,,,,,2613,562,238,324,90,41,49,1791,710,1081,58,18,40,10,4,6,16,6,10
,,,,,,,,,,,,,,,,,,,,8267,5685,2750,2935,384,162,222,2050,850,1200,52,22,30,38,22,16,0,0,0
,,,,,,,,,,,,,,,,,,,,199,3,0,3,1,1,0,195,42,153,0,0,0,0,0,0,0,0,0
,,,,,,,,,,,,,,,,,,,,221,3,1,2,0,0,0,218,43,175,0,0,0,0,0,0,0,0,0
,,,,,,,,,,,,,,,,,,,,5836,4382,2032,2350,339,130,209,483,195,288,348,156,192,43,17,26,0,0,0
,,,,,,,,,,,,,,,,,,,,208,16,1,15,5,0,5,187,10,177,0,0,0,0,0,0,0,0,0
,,,,,,,,,,,,,,,,,,,,3856,781,329,452,55,42,13,2893,1019,1874,16,8,8,11,4,7,46,22,24
,,,,,,,,,,,,,,,,,,,,1607,1199,560,639,91,60,31,242,117,125,22,7,15,40,19,21,0,0,0
,,,,,,,,,,,,,,,,,,,,1320,1063,482,581,39,15,24,162,57,105,31,12,19,7,1,6,17,5,12
,,,,,,,,,,,,,,,,,,,,10300,7908,3408,4500,1550,536,1014,650,288,362,98,46,52,51,24,27,0,0,0
,,,,,,,,,,,,,,,,,,,,20179,14478,6415,8063,1018,447,571,3800,1789,2011,358,158,200,103,50,53,232,124,108
,,,,,,,,,,,,,,,,,,,,1163,579,201,378,165,76,89,178,76,102,65,26,39,12,3,9,9,4,5
,,,,,,,,,,,,,,,,,,,,197,1,1,0,174,95,79,3,0,3,0,0,0,0,0,0,1,0,1
,,,,,,,,,,,,,,,,,,,,1993,800,408,392,69,56,13,1098,440,658,10,6,4,8,6,2,2,2,0
,,,,,,,,,,,,,,,,,,,,6715,5671,2585,3086,450,220,230,439,213,226,51,17,34,61,29,32,3,1,2
,,,,,,,,,,,,,,,,,,,,28852,19422,8432,10990,3489,1179,2310,3948,1675,2273,1642,827,815,223,106,117,0,0,0
,,,,,,,,,,,,,,,,,,,,3585,2636,1079,1557,411,136,275,473,170,303,31,15,16,27,11,16,0,0,0
,,,,,,,,,,,,,,,,,,,,215,122,33,89,27,9,18,22,6,16,12,4,8,3,1,2,24,4,20
,,,,,,,,,,,,,,,,,,,,896,405,130,275,58,15,43,336,106,230,38,12,26,4,2,2,48,6,42
,,,,,,,,,,,,,,,,,,,,562,345,42,303,68,16,52,86,18,68,38,6,32,3,0,3,18,2,16
,,,,,,,,,,,,,,,,,,,,3875,3128,1264,1864,689,206,483,37,14,23,11,4,7,4,2,2,0,0,0
,,,,,,,,,,,,,,,,,,,,5003,1331,706,625,258,152,106,3292,1604,1688,27,13,14,10,7,3,8,4,4
,,,,,,,,,,,,,,,,,,,,36603,30040,15315,14725,889,365,524,3283,1697,1586,1203,667,536,187,107,80,529,280,249
,,,,,,,,,,,,,,,,,,,,16329,9446,4451,4995,2131,735,1396,1994,893,1101,1812,934,878,131,64,67,0,0,0
,,,,,,,,,,,,,,,,,,,,38609,24199,11808,12391,1335,567,768,5236,2542,2694,6124,3148,2976,164,73,91,212,87,125
,,,,,,,,,,,,,,,,,,,,7490,4280,2227,2053,551,256,295,637,319,318,1601,861,740,38,16,22,41,13,28
,,,,,,,,,,,,,,,,,,,,13642,1609,751,858,330,190,140,9890,4232,5658,166,84,82,41,20,21,0,0,0
,,,,,,,,,,,,,,,,,,,,2696,2279,808,1471,230,51,179,100,40,60,27,9,18,28,9,19,5,2,3
,,,,,,,,,,,,,,,,,,,,6885,5415,2215,3200,307,137,170,395,187,208,128,53,75,36,15,21,297,171,126
,,,,,,,,,,,,,,,,,,,,511,4,2,2,494,183,311,9,3,6,3,2,1,1,0,1,0,0,0
,,,,,,,,,,,,,,,,,,,,16,14,2,12,1,0,1,1,1,0,0,0,0,0,0,0,0,0,0
,,,,,,,,,,,,,,,,,,,,1473,1050,461,589,80,43,37,247,122,125,29,15,14,11,6,5,11,7,4
,,,,,,,,,,,,,,,,,,,,1780,1048,347,701,56,20,36,635,223,412,16,10,6,10,7,3,11,4,7
,,,,,,,,,,,,,,,,,,,,16856,6862,3135,3727,931,405,526,8037,3598,4439,658,318,340,76,41,35,0,0,0
,,,,,,,,,,,,,,,,,,,,6485,74,35,39,5807,2561,3246,161,82,79,130,62,68,6,3,3,0,0,0
,,,,,,,,,,,,,,,,,,,,21269,17608,9326,8282,641,371,270,2169,1210,959,463,275,188,116,64,52,113,57,56
,,,,,,,,,,,,,,,,,,,,1714,998,370,628,296,75,221,275,99,176,50,20,30,19,7,12,25,3,22
,,,,,,,,,,,,,,,,,,,,4405,2685,167,2518,923,18,905,479,42,437,201,12,189,31,4,27,0,0,0
,,,,,,,,,,,,,,,,,,,,2383,1663,814,849,51,36,15,248,112,136,159,77,82,15,7,8,205,90,115
,,,,,,,,,,,,,,,,,,,,332,201,17,184,46,5,41,42,2,40,40,9,31,0,0,0,0,0,0
,,,,,,,,,,,,,,,,,,,,463,380,51,329,18,5,13,46,10,36,16,5,11,1,0,1,1,1,0
,,,,,,,,,,,,,,,,,,,,8546,6169,2575,3594,1672,672,1000,517,223,294,101,47,54,38,11,27,0,0,0
,,,,,,,,,,,,,,,,,,,,1650,624,619,5,142,141,1,327,326,1,32,32,0,11,11,0,510,503,7
,,,,,,,,,,,,,,,,,,,,268,6,0,6,1,0,1,259,9,250,2,1,1,0,0,0,0,0,0
,,,,,,,,,,,,,,,,,,,,2269,1760,713,1047,170,46,124,257,105,152,41,16,25,33,11,22,0,0,0
,,,,,,,,,,,,,,,,,,,,80,25,0,25,17,4,13,36,3,33,1,0,1,0,0,0,1,0,1
,,,,,,,,,,,,,,,,,,,,4010,2584,984,1600,191,43,148,1168,399,769,44,20,24,9,5,4,0,0,0
,,,,,,,,,,,,,,,,,,,,5028,2462,1449,1013,768,400,368,665,334,331,109,72,37,40,20,20,972,556,416
,,,,,,,,,,,,,,,,,,,,3161,2420,937,1483,60,27,33,173,69,104,27,8,19,22,10,12,424,195,229
,,,,,,,,,,,,,,,,,,,,5395,4312,1842,2470,184,105,79,685,308,377,76,32,44,37,22,15,0,0,0
,,,,,,,,,,,,,,,,,,,,1367,972,542,430,120,98,22,258,139,119,7,4,3,6,5,1,0,0,0
,,,,,,,,,,,,,,,,,,,,5282,3296,1413,1883,537,149,388,1121,436,685,258,113,145,9,6,3,44,23,21
,,,,,,,,,,,,,,,,,,,,584,10,10,0,515,223,292,4,2,2,0,0,0,2,0,2,0,0,0
,,,,,,,,,,,,,,,,,,,,6152,1923,735,1188,157,69,88,3966,1457,2509,66,27,39,28,12,16,0,0,0
,,,,,,,,,,,,,,,,,,,,20,13,0,13,5,1,4,2,0,2,0,0,0,0,0,0,0,0,0
,,,,,,,,,,,,,,,,,,,,85,33,2,31,15,1,14,32,0,32,5,0,5,0,0,0,0,0,0
,,,,,,,,,,,,,,,,,,,,99,35,6,29,9,2,7,20,2,18,35,10,25,0,0,0,0,0,0
,,,,,,,,,,,,,,,,,,,,48,32,21,11,11,7,4,5,5,0,0,0,0,0,0,0,0,0,0
,,,,,,,,,,,,,,,,,,,,14497,10418,4565,5853,773,304,469,946,421,525,545,273,272,73,23,50,15,7,8
,,,,,,,,,,,,,,,,,,,,170,120,9,111,12,1,11,21,3,18,15,2,13,2,1,1,0,0,0
,,,,,,,,,,,,,,,,,,,,31,9,1,8,9,0,9,11,1,10,2,0,2,0,0,0,0,0,0
,,,,,,,,,,,,,,,,,,,,229,16,4,12,15,0,15,186,50,136,1,1,0,0,0,0,0,0,0
,,,,,,,,,,,,,,,,,,,,123,59,34,25,48,20,28,15,7,8,1,0,1,0,0,0,0,0,0
,,,,,,,,,,,,,,,,,,,,40,2,0,2,23,5,18,15,5,10,0,0,0,0,0,0,0,0,0
,,,,,,,,,,,,,,,,,,,,34,18,1,17,0,0,0,15,1,14,1,0,1,0,0,0,0,0,0
,,,,,,,,,,,,,,,,,,,,135,22,1,21,48,5,43,64,3,61,1,0,1,0,0,0,0,0,0
,,,,,,,,,,,,,,,,,,,,104,4,0,4,1,0,1,1,0,1,98,17,81,0,0,0,0,0,0
,,,,,,,,,,,,,,,,,,,,253,38,3,35,129,6,123,82,4,78,4,0,4,0,0,0,0,0,0
,,,,,,,,,,,,,,,,,,,,815,354,134,220,174,60,114,194,77,117,93,63,30,0,0,0,0,0,0
,,,,,,,,,,,,,,,,,,,,35,2,0,2,0,0,0,33,1,32,0,0,0,0,0,0,0,0,0
,,,,,,,,,,,,,,,,,,,,140,115,114,1,9,9,0,9,9,0,1,1,0,0,0,0,0,0,0
,,,,,,,,,,,,,,,,,,,,43,2,1,1,19,3,16,22,4,18,0,0,0,0,0,0,0,0,0
,,,,,,,,,,,,,,,,,,,,27,0,0,0,0,0,0,27,5,22,0,0,0,0,0,0,0,0,0
,,,,,,,,,,,,,,,,,,,,54,34,4,30,3,0,3,15,0,15,1,0,1,1,0,1,0,0,0
,,,,,,,,,,,,,,,,,,,,402,322,239,83,13,7,6,25,18,7,16,10,6,3,2,1,23,12,11
,,,,,,,,,,,,,,,,,,,,112,10,0,10,33,3,30,62,5,57,7,2,5,0,0,0,0,0,0
,,,,,,,,,,,,,,,,,,,,162,60,8,52,54,10,44,46,9,37,2,0,2,0,0,0,0,0,0
,,,,,,,,,,,,,,,,,,,,207,0,0,0,71,4,67,136,20,116,0,0,0,0,0,0,0,0,0
,,,,,,,,,,,,,,,,,,,,150,67,22,45,38,3,35,35,7,28,9,3,6,1,0,1,0,0,0
,,,,,,,,,,,,,,,,,,,,45,28,0,28,15,1,14,1,0,1,1,1,0,0,0,0,0,0,0
,,,,,,,,,,,,,,,,,,,,120,66,23,43,20,10,10,25,12,13,2,1,1,2,0,2,1,0,1
,,,,,,,,,,,,,,,,,,,,98,48,0,48,10,0,10,20,0,20,20,0,20,0,0,0,0,0,0
,,,,,,,,,,,,,,,,,,,,317,2,0,2,31,2,29,254,42,212,30,4,26,0,0,0,0,0,0
,,,,,,,,,,,,,,,,,,,,133,37,0,37,6,0,6,37,1,36,52,15,37,1,0,1,0,0,0
,,,,,,,,,,,,,,,,,,,,1230,193,112,81,744,419,325,268,151,117,17,3,14,0,0,0,8,4,4
,,,,,,,,,,,,,,,,,,,,293,50,3,47,140,20,120,97,19,78,5,0,5,0,0,0,1,0,1
,,,,,,,,,,,,,,,,,,,,41,0,0,0,0,0,0,0,0,0,0,0,0,0,0,0,41,9,32
,,,,,,,,,,,,,,,,,,,,184,11,1,10,4,0,4,169,10,159,0,0,0,0,0,0,0,0,0
,,,,,,,,,,,,,,,,,,,,261,40,5,35,24,5,19,195,11,184,2,0,2,0,0,0,0,0,0
,,,,,,,,,,,,,,,,,,,,35,12,2,10,6,1,5,15,0,15,1,0,1,0,0,0,1,0,1
,,,,,,,,,,,,,,,,,,,,88,1,1,0,0,0,0,87,3,84,0,0,0,0,0,0,0,0,0
,,,,,,,,,,,,,,,,,,,,266,9,3,6,4,4,0,250,45,205,3,0,3,0,0,0,0,0,0
,,,,,,,,,,,,,,,,,,,,12469,579,269,310,11,2,9,11782,4710,7072,93,42,51,4,3,1,0,0,0
,,,,,,,,,,,,,,,,,,,,113,63,2,61,11,0,11,17,0,17,20,5,15,0,0,0,0,0,0
,,,,,,,,,,,,,,,,,,,,48,31,11,20,3,1,2,1,0,1,10,4,6,1,1,0,1,0,1
,,,,,,,,,,,,,,,,,,,,100,89,47,42,5,4,1,2,1,1,1,1,0,2,0,2,0,0,0
,,,,,,,,,,,,,,,,,,,,36,0,0,0,0,0,0,34,4,30,0,0,0,0,0,0,0,0,0
,,,,,,,,,,,,,,,,,,,,173,3,0,3,1,0,1,28,1,27,141,33,108,0,0,0,0,0,0
,,,,,,,,,,,,,,,,,,,,38,19,0,19,2,1,1,17,0,17,0,0,0,0,0,0,0,0,0
,,,,,,,,,,,,,,,,,,,,5143,2492,1088,1404,237,100,137,2178,897,1281,206,91,115,20,14,6,0,0,0
,,,,,,,,,,,,,,,,,,,,59,12,4,8,17,16,1,23,14,9,5,1,4,2,0,2,0,0,0
,,,,,,,,,,,,,,,,,,,,152,17,7,10,26,5,21,107,18,89,2,0,2,0,0,0,0,0,0
,,,,,,,,,,,,,,,,,,,,90,18,2,16,2,1,1,10,1,9,60,9,51,0,0,0,0,0,0
,,,,,,,,,,,,,,,,,,,,86,2,1,1,1,1,0,82,73,9,1,0,1,0,0,0,0,0,0
,,,,,,,,,,,,,,,,,,,,49,32,2,30,12,0,12,5,0,5,0,0,0,0,0,0,0,0,0
,,,,,,,,,,,,,,,,,,,,55,25,2,23,10,0,10,1,0,1,19,3,16,0,0,0,0,0,0
,,,,,,,,,,,,,,,,,,,,84,67,8,59,3,0,3,10,3,7,3,0,3,1,0,1,0,0,0
,,,,,,,,,,,,,,,,,,,,57,0,0,0,0,0,0,57,13,44,0,0,0,0,0,0,0,0,0
,,,,,,,,,,,,,,,,,,,,97,4,0,4,79,6,73,5,1,4,2,0,2,0,0,0,0,0,0
,,,,,,,,,,,,,,,,,,,,166,7,1,6,14,1,13,61,4,57,52,11,41,31,13,18,1,0,1
,,,,,,,,,,,,,,,,,,,,197,39,3,36,21,8,13,99,19,80,1,0,1,0,0,0,37,9,28
,,,,,,,,,,,,,,,,,,,,244,105,60,45,136,75,61,3,2,1,0,0,0,0,0,0,0,0,0
,,,,,,,,,,,,,,,,,,,,196,131,71,60,20,8,12,23,15,8,7,5,2,1,1,0,14,7,7
,,,,,,,,,,,,,,,,,,,,112,17,4,13,4,2,2,90,15,75,1,1,0,0,0,0,0,0,0
,,,,,,,,,,,,,,,,,,,,205,0,0,0,0,0,0,0,0,0,0,0,0,0,0,0,205,46,159